5

176
21 21 1 2 4 3 1 2 3 3 1 2 3 3 1 2 
21 21 1 4 3 3 1 2 3 3 1 2 7 8 1 2 
21 21 21 21 3 3 1 2 3 3 1 2 13 14 1 2 
21 21 1 2 7 8 1 2 7 8 1 2 13 14 1 2 
21 21 21 21 21 21 21 21 21 21 21 21 21 21 21 21 
21 21 1 2 10 11 12 9 10 11 12 9 10 11 12 9 
21 21 1 2 15 15 1 2 15 15 1 2 15 15 1 2 
21 21 1 2 16 17 1 2 3 3 1 2 16 17 1 2 
21 21 1 2 22 23 1 2 3 3 1 2 22 23 1 2 
21 21 1 2 19 20 1 2 3 3 1 2 19 20 1 2 
21 21 1 2 25 26 1 2 3 3 1 2 25 26 1 2 

176
3 3 1 2 3 3 3 3 3 3 1 2 22 23 1 2 
3 3 1 2 3 3 3 3 16 17 1 2 3 3 1 2 
3 3 21 21 3 3 3 3 22 23 1 2 3 3 1 2 
7 8 1 2 7 8 13 14 13 14 1 2 7 8 1 2 
21 21 1 2 21 21 21 21 21 21 21 21 21 21 21 21 
10 11 12 9 10 11 12 9 10 11 12 9 10 11 12 9 
15 15 1 2 15 15 1 2 15 15 1 2 15 15 1 2 
16 17 1 2 16 17 1 2 16 17 1 2 16 17 1 2 
22 23 1 2 22 23 1 2 22 23 1 2 22 23 1 2 
19 20 1 2 7 8 1 2 3 3 1 2 19 20 1 2 
25 26 1 2 13 14 1 2 3 3 1 2 25 26 1 2 

176
3 3 1 2 3 3 1 2 3 3 1 2 3 3 1 2 
3 3 1 2 3 3 1 2 3 3 1 2 3 3 1 2 
3 3 1 2 3 3 1 2 3 3 1 2 3 3 1 2 
7 8 1 2 13 14 1 2 13 14 1 2 7 8 1 2 
21 21 21 21 21 21 21 21 21 21 21 21 21 21 21 21 
10 11 12 9 10 11 12 9 10 11 12 9 10 11 21 21 
15 15 1 2 15 15 1 2 15 15 1 2 15 15 21 21 
16 17 1 2 16 17 1 2 16 17 1 2 16 17 21 21 
22 23 1 2 22 23 1 2 22 23 1 2 22 23 21 21 
3 3 1 2 19 20 1 2 3 3 1 2 19 20 21 21 
3 3 1 2 25 26 1 2 3 3 1 2 25 26 21 21 

176
21 3 22 23 25 26 1 2 3 3 25 26 22 23 3 3 
15 18 19 20 3 3 1 2 7 8 16 17 3 3 3 3 
15 24 25 26 3 3 1 2 13 14 22 23 3 3 3 3 
15 30 3 3 16 17 1 2 13 14 3 3 7 8 7 8 
21 21 3 3 22 23 21 21 21 21 3 3 21 21 21 21 
21 3 3 3 13 14 1 2 21 21 3 3 3 3 21 21 
21 3 3 3 21 21 1 2 21 21 3 3 3 3 21 21 
21 3 16 17 19 20 1 2 21 21 3 3 16 17 21 21 
21 3 22 23 25 26 1 2 21 21 3 3 22 23 21 21 
21 3 7 8 3 3 1 2 21 21 3 3 3 3 21 21 
21 3 13 14 3 3 1 2 21 21 3 3 3 3 21 21 

176
1 2 3 3 22 23 1 2 3 3 3 3 22 23 21 21 
1 2 16 17 3 3 1 2 7 8 16 17 3 3 21 21 
1 2 22 23 3 3 1 2 13 14 22 23 3 3 21 21 
1 2 19 20 3 3 1 2 13 14 7 8 3 3 21 21 
21 21 25 26 3 3 15 21 21 21 21 21 3 3 21 21 
21 3 7 8 7 8 21 21 19 20 7 8 3 3 21 21 
21 3 21 21 13 14 21 21 25 26 13 14 6 21 21 21 
21 3 3 3 13 14 21 21 3 3 3 4 1 2 21 21 
21 3 3 3 21 21 21 21 3 3 4 3 1 2 21 21 
21 3 3 3 3 3 3 3 3 4 3 3 1 2 21 21 
21 3 3 3 3 3 3 3 4 3 3 3 1 2 21 21 