2

176
1 2 4 13 14 9 1 2 9 9 9 9 1 2 9 9 
11 12 4 4 13 14 11 22 9 9 9 9 11 22 9 9 
11 12 4 4 4 13 21 22 9 9 9 9 21 22 9 9 
11 22 4 4 4 4 3 3 9 9 9 9 11 22 9 9 
21 22 4 4 4 4 1 2 9 9 9 9 21 22 9 9 
3 3 3 3 3 3 3 3 3 3 3 3 3 3 9 9 
1 2 23 24 23 24 1 2 7 8 23 24 1 2 9 9 
11 22 9 9 9 9 11 22 17 18 25 25 11 12 9 10 
21 22 9 9 9 9 21 22 9 9 25 25 11 12 19 20 
5 6 5 6 5 6 5 6 5 6 5 6 5 6 5 6 
15 16 15 16 15 16 15 16 15 16 15 16 15 16 15 16 

176
1 2 9 9 11 12 4 13 14 9 9 9 11 12 26 27 
11 12 9 9 11 12 4 4 13 14 9 9 11 12 26 27 
11 12 9 9 11 12 4 4 4 13 14 9 11 12 26 27 
11 12 9 9 11 12 4 4 4 4 13 14 11 12 26 27 
11 12 9 9 11 12 4 4 4 4 4 13 11 12 26 27 
3 3 9 9 3 3 3 3 3 3 3 3 3 9 26 27 
11 12 9 9 1 2 23 24 23 24 23 24 1 2 26 27 
11 12 9 10 11 12 25 25 9 10 9 9 11 12 3 3 
11 12 19 20 11 12 25 25 19 20 9 9 11 12 23 24 
5 6 5 6 5 6 5 6 5 6 5 6 3 3 5 6 
15 16 15 16 15 16 15 16 15 16 15 16 1 2 15 16 