1

176
1 2 3 4 2 2 2 2 9 2 5 6 3 4 1 1 
1 2 3 4 2 2 12 9 2 2 13 14 3 4 1 1 
1 2 3 4 2 2 9 2 2 2 21 22 3 4 1 1 
1 1 3 4 12 9 5 6 17 18 2 2 3 4 1 1 
1 1 1 1 1 1 1 1 1 1 2 2 3 4 1 1 
1 1 3 4 13 14 2 2 2 2 2 2 3 4 1 1 
1 1 3 4 21 22 2 2 2 12 20 1 1 1 1 1 
8 7 3 4 2 2 2 2 12 9 2 2 17 18 1 1 
16 15 3 4 2 2 2 2 9 2 2 2 5 6 1 1 
24 23 3 4 5 6 12 9 17 18 17 18 5 6 1 1 
1 1 1 1 1 1 1 1 1 1 1 1 1 1 1 1 
