11

176
1 2 9 10 3 4 1 2 1 2 9 10 3 4 1 2 
21 22 9 10 23 24 89 90 61 62 9 10 23 24 89 90 
41 42 9 10 43 44 5 6 1 2 9 10 43 44 5 6 
61 62 9 10 63 64 70 70 61 62 9 10 23 24 70 70 
1 2 9 10 83 84 70 70 1 2 9 10 43 44 70 70 
61 62 9 10 61 62 70 70 61 62 9 10 63 64 70 70 
1 2 9 10 1 2 70 70 1 2 9 10 83 84 70 70 
61 62 9 10 61 62 70 70 89 90 9 10 61 62 70 70 
1 2 9 10 1 2 70 70 5 6 9 10 1 2 70 70 
81 82 29 30 81 82 81 82 81 82 29 30 81 82 81 82 
50 50 50 50 50 50 50 50 50 50 50 50 50 50 50 50 

176
1 2 9 10 11 12 1 2 1 2 9 10 3 4 1 2 
61 62 9 10 11 54 89 90 61 62 9 10 23 24 89 90 
1 2 9 10 3 4 5 6 1 2 9 10 43 44 5 6 
61 62 9 10 23 24 70 70 61 62 9 10 23 24 70 70 
1 2 9 10 43 44 70 70 1 2 9 10 43 44 70 70 
89 90 9 10 23 24 70 70 61 62 9 10 63 64 70 70 
5 6 9 10 43 44 70 70 1 2 9 10 83 84 70 70 
21 22 9 10 63 64 70 70 61 62 9 10 61 62 70 70 
41 42 9 10 83 84 70 70 1 2 9 10 1 2 70 70 
81 82 29 30 81 82 81 82 81 82 29 30 81 82 81 82 
50 50 50 50 50 50 50 50 50 50 50 50 50 50 50 50

176
5 6 9 10 3 4 5 6 1 2 1 2 1 2 1 2 
21 22 9 10 23 24 70 70 61 62 61 62 61 62 61 62 
41 42 9 10 43 44 70 70 1 2 1 2 1 2 1 2 
61 62 9 10 23 24 70 70 61 62 61 62 51 52 45 7 
1 2 9 10 43 44 70 70 1 2 1 2 31 45 46 50 
61 62 9 10 23 24 70 70 51 52 45 7 25 46 27 26 
1 2 9 10 43 44 70 70 31 45 46 50 50 50 65 66 
21 22 9 10 63 64 51 52 73 46 27 26 89 90 61 62 
41 42 9 10 83 84 31 45 46 47 65 66 5 6 1 2 
81 82 29 30 81 82 25 46 81 82 81 82 81 82 81 82 
50 50 50 50 50 50 50 50 50 50 50 50 50 50 50 50


176
9 10 3 4 70 70 9 10 41 42 1 2 1 2 5 6 
9 10 63 64 70 70 9 10 61 62 61 62 61 62 21 22 
9 10 83 84 70 70 9 10 1 2 1 2 1 2 41 42 
29 30 81 82 32 32 32 32 71 68 13 14 61 62 61 62 
50 50 50 50 50 50 50 50 50 85 86 91 1 2 1 2 
9 10 61 62 21 22 9 10 72 88 85 67 81 82 32 32 
9 10 1 2 41 42 9 10 92 69 50 50 50 50 50 35 
9 10 61 62 61 62 9 10 61 62 9 10 89 90 89 90 
9 10 1 2 1 2 9 10 1 2 9 10 5 6 5 6 
29 30 81 82 81 82 29 30 81 82 29 30 81 82 81 82 
50 50 50 50 50 50 50 50 50 50 50 50 50 50 50 50 

176
9 10 5 6 9 10 5 6 9 10 5 6 9 10 1 2 
9 10 70 70 9 10 70 70 9 10 70 70 9 10 61 62 
9 10 70 70 9 10 70 70 9 10 70 70 9 10 1 2 
9 10 70 70 9 10 70 70 9 10 70 70 9 10 89 90 
9 10 70 70 9 10 70 70 9 10 70 70 9 10 5 6 
9 10 70 70 9 10 70 70 9 10 70 70 9 10 21 22 
9 10 70 70 9 10 70 70 9 10 70 70 9 10 41 42 
9 10 70 70 9 10 70 70 9 10 70 70 9 10 89 90 
9 10 70 70 9 10 70 70 9 10 70 70 9 10 5 6 
29 30 81 82 29 30 81 82 29 30 81 82 29 30 81 82 
50 50 50 50 50 50 50 50 50 50 50 50 50 50 50 50 

176
5 6 1 2 41 42 41 42 1 2 70 70 9 10 48 87 
70 70 61 62 61 62 61 62 61 62 70 70 9 10 8 35 
70 70 1 2 1 2 1 2 1 2 70 70 9 10 8 35 
70 70 61 62 51 52 45 7 32 32 81 82 29 30 8 35 
70 70 1 2 31 45 46 50 50 50 50 50 50 50 50 50 
70 70 51 52 73 46 27 26 61 62 61 62 33 34 28 87 
70 70 31 45 46 47 65 66 1 2 1 2 9 10 48 87 
51 52 73 46 27 26 89 90 61 62 61 62 9 10 28 87 
31 45 46 47 65 66 5 6 1 2 1 2 9 10 48 87 
25 46 81 82 81 82 81 82 81 82 81 82 29 30 49 87 
50 50 50 50 50 50 50 50 50 50 50 50 50 50 50 50 

176
93 8 8 8 8 8 9 10 8 8 8 8 8 8 8 8 
35 8 8 74 8 8 9 96 8 8 57 8 57 8 57 8 
35 8 40 94 8 8 95 96 8 8 8 8 8 8 8 8 
35 8 8 8 8 8 29 30 8 8 8 8 15 16 15 16 
50 50 50 50 50 50 50 50 8 8 8 8 35 36 35 36 
93 8 15 16 15 16 9 10 8 8 32 55 8 8 15 16 
93 8 35 36 35 36 9 10 50 50 50 75 76 53 35 36 
93 8 8 8 8 8 9 96 15 16 9 10 85 55 8 8 
93 8 8 8 8 8 95 96 35 36 9 10 56 85 76 53 
93 8 32 55 8 8 29 30 8 8 29 30 8 60 85 18 
50 50 50 75 50 50 50 50 50 50 50 50 50 50 50 50 

176
95 96 8 8 95 96 8 8 8 8 8 8 8 8 50 50 
9 96 8 74 9 10 8 8 8 8 57 8 57 8 53 35 
95 96 40 94 9 10 8 8 8 8 8 8 8 8 53 35 
9 10 15 16 9 10 8 8 8 74 8 8 8 8 53 35 
9 10 35 36 9 10 8 8 40 94 50 50 50 50 50 50 
17 37 17 37 50 50 8 8 32 55 8 8 8 74 77 78 
37 37 37 37 33 34 50 50 50 75 76 53 40 94 77 78 
17 37 17 37 9 96 15 16 9 10 85 55 8 8 77 78 
35 37 37 37 95 96 35 36 9 10 56 85 76 53 77 78 
35 37 17 37 29 30 32 55 29 30 8 60 85 18 97 78 
37 37 37 37 50 50 50 75 50 50 50 50 50 50 50 50 

176
1 2 1 2 9 10 41 42 1 2 9 10 5 6 1 2 
61 62 21 22 9 10 61 62 61 62 9 10 70 70 61 62 
1 2 41 42 9 10 1 2 1 2 9 10 70 70 1 2 
81 82 32 32 32 32 71 68 13 14 9 10 70 70 61 62 
50 50 50 50 50 50 50 85 86 91 9 10 70 70 1 2 
11 54 61 62 33 34 72 88 85 67 32 32 81 82 32 32 
3 4 1 2 9 10 92 69 50 50 50 50 50 50 50 50 
63 64 61 62 9 10 61 62 89 90 9 10 21 22 9 10 
83 84 1 2 9 10 1 2 5 6 9 10 41 42 9 10 
81 82 81 82 29 30 81 82 81 82 29 30 81 82 29 30 
50 50 50 50 50 50 50 50 50 50 50 50 50 50 50 50 

176
9 10 3 4 92 69 79 38 1 2 39 20 9 10 79 38 
9 10 23 24 21 22 61 62 33 34 19 59 9 10 98 99 
9 10 43 44 41 42 1 2 9 10 39 20 9 10 79 38 
9 10 63 64 61 62 61 62 9 10 61 62 9 10 61 62 
9 10 83 84 1 2 1 2 9 10 1 2 9 10 1 2 
32 32 71 68 13 14 61 62 9 10 61 62 9 10 61 62 
50 50 50 85 86 91 1 2 9 10 1 2 9 10 1 2 
21 22 72 88 85 86 13 14 9 10 61 62 9 10 61 62 
41 42 92 69 58 85 86 91 9 10 1 2 9 10 1 2 
81 82 81 82 81 82 85 67 29 30 81 82 29 30 81 82 
50 50 50 50 50 50 50 50 50 50 50 50 50 50 50 50 

176
1 2 39 20 9 10 79 38 1 2 11 12 5 6 48 87 
33 34 19 59 9 10 98 99 33 34 11 54 70 70 28 87 
9 10 39 20 9 10 79 38 9 10 3 4 70 70 48 87 
9 10 61 62 9 10 89 90 9 10 63 64 70 70 8 80 
9 10 1 2 9 10 5 6 9 10 83 84 70 70 8 100 
9 10 61 62 9 10 21 22 9 10 51 52 45 7 8 120 
9 10 1 2 9 10 41 42 9 10 31 45 46 50 50 50 
9 10 61 62 9 10 61 62 9 10 25 46 27 26 28 87 
9 10 1 2 9 10 1 2 9 10 50 35 65 66 48 87 
29 30 81 82 29 30 81 82 29 30 81 82 81 82 49 87 
50 50 50 50 50 50 50 50 50 50 50 50 50 50 50 50 