3

176
1 1 23 23 23 23 13 14 23 23 23 23 37 38 6 7 
1 1 23 23 23 23 25 26 23 23 23 23 37 38 18 19 
1 1 23 23 30 31 25 26 30 31 23 23 37 38 6 7 
1 1 23 23 42 43 25 26 42 43 23 23 37 38 17 17 
1 1 30 31 42 43 25 26 42 43 30 31 37 38 17 17 
24 10 42 43 42 43 23 23 42 43 42 43 37 38 17 17 
36 22 42 43 42 43 23 23 42 43 42 43 37 38 17 17 
48 34 46 47 46 47 44 45 46 47 46 47 37 38 1 1 
1 1 1 1 1 1 1 1 1 1 1 1 1 1 17 17 
18 19 18 19 18 19 18 19 18 19 18 19 18 19 18 19 
6 7 6 7 6 7 6 7 6 7 6 7 6 7 6 7 

176
6 7 6 7 6 7 6 7 6 7 6 7 6 7 6 7 
18 19 3 4 8 9 3 4 5 2 3 4 5 2 3 4 
6 7 23 23 37 38 23 23 37 38 23 23 37 38 23 23 
17 17 15 16 37 38 15 16 37 38 15 16 37 38 15 16 
17 17 27 28 37 38 27 28 37 38 27 28 37 38 27 28 
17 17 39 40 37 38 39 40 37 38 39 40 37 38 39 40 
17 17 27 28 37 38 27 28 37 38 27 28 37 38 27 28 
1 1 1 1 1 1 1 1 1 1 1 1 1 1 1 1 
17 17 17 17 17 17 17 17 17 17 17 17 17 17 17 17 
18 19 3 4 5 2 3 4 5 2 3 4 5 2 3 4 
6 7 23 23 37 38 23 23 37 38 23 23 37 38 23 23 

176
6 7 6 7 6 7 6 7 6 7 6 7 6 7 1 1 
5 2 3 4 5 2 3 4 5 2 3 4 17 17 1 1 
37 38 23 23 37 38 23 23 37 38 23 23 17 17 1 1 
37 38 15 16 37 38 15 16 37 38 15 16 17 17 1 1 
37 38 27 28 37 38 27 28 37 38 27 28 17 17 1 1 
37 38 39 40 37 38 39 40 37 38 39 40 17 17 1 1 
37 38 27 28 37 38 27 28 37 38 27 28 17 17 1 1 
1 1 1 1 1 1 1 1 1 1 1 1 17 17 1 1 
17 17 17 17 17 17 17 17 17 17 17 17 29 1 1 1 
5 2 3 4 5 2 3 4 5 2 35 41 17 17 1 1 
37 38 23 23 37 38 23 23 37 38 41 17 17 17 1 1 