6

176
1 1 29 30 29 30 29 30 29 30 29 30 29 30 29 30 
1 1 3 4 5 2 3 4 5 2 3 4 5 2 3 4 
1 1 15 15 13 14 15 15 13 14 15 15 13 14 15 15 
1 1 11 11 13 14 11 11 13 14 11 11 13 14 15 15 
1 1 11 11 13 14 11 11 13 14 11 11 13 14 1 1 
1 1 11 11 13 14 11 11 13 14 21 31 1 1 19 19 
1 1 11 11 13 14 11 11 13 14 31 19 19 19 19 19 
1 1 11 12 13 14 11 12 15 1 32 33 22 23 22 23 
1 1 1 1 1 1 1 1 1 1 1 1 1 1 1 1 
1 1 39 40 39 40 39 40 39 40 39 40 39 40 40 40 
1 1 29 30 29 30 29 30 29 30 29 30 29 30 29 30 

176
19 19 15 15 13 14 15 15 13 14 15 15 13 14 15 15 
32 33 15 15 13 14 15 15 13 14 15 15 13 14 15 15 
1 1 1 1 1 1 1 1 1 1 1 1 1 1 1 1 
19 19 3 4 5 2 3 4 5 2 3 4 5 2 3 4 
19 19 15 15 13 14 15 15 13 14 15 15 13 14 15 15 
22 23 15 15 13 14 15 15 13 14 15 15 13 14 15 15 
32 33 15 15 13 14 15 15 13 14 15 15 13 14 15 15 
32 33 15 15 13 14 15 15 13 14 15 15 13 14 15 15 
1 1 1 1 1 1 1 1 1 1 1 1 1 1 1 1 
40 40 39 40 39 40 39 40 39 40 39 40 40 40 1 1 
29 30 29 30 29 30 29 30 29 30 29 30 29 30 1 1 

176
13 14 15 15 13 14 15 15 19 19 16 19 19 19 1 1 
13 14 15 15 13 14 15 15 17 16 32 33 22 23 1 1 
1 1 1 1 1 1 1 1 1 1 1 1 1 1 1 1 
5 2 3 4 5 2 3 4 13 14 19 19 19 19 24 25 
13 14 15 15 13 14 15 15 13 14 19 19 19 19 34 35 
13 14 11 11 13 14 11 11 13 14 19 19 32 33 22 23 
13 14 11 11 13 14 11 11 13 14 19 19 15 1 1 1 
13 14 11 11 13 14 11 11 13 14 1 1 1 1 1 1 
13 14 11 11 13 14 11 11 13 14 1 1 1 1 1 1 
13 14 11 12 13 14 11 12 13 14 1 1 1 1 1 1 
1 1 1 1 1 1 1 1 1 1 1 1 1 1 1 1 

176
1 1 13 14 36 37 13 14 19 19 13 14 36 37 13 14 
1 1 13 14 19 19 13 14 26 27 13 14 5 5 13 14 
1 1 13 14 19 19 13 14 36 37 13 14 5 5 13 14 
15 18 13 14 22 23 13 14 22 23 13 14 22 23 13 14 
15 28 13 14 1 1 1 1 1 1 1 1 1 1 1 1 
15 38 13 14 24 25 5 2 3 4 5 2 3 4 5 2 
1 1 1 1 34 35 13 14 15 15 13 14 15 15 13 14 
1 1 6 7 26 27 13 14 19 19 13 14 19 19 13 14 
1 1 13 14 36 37 13 14 19 19 13 14 19 19 1 1 
1 1 13 14 17 16 1 1 24 25 1 1 3 4 5 2 
1 1 13 14 16 19 6 7 34 35 6 7 15 15 13 14 

176
32 33 19 19 19 19 34 35 19 19 13 14 36 37 13 14 
24 25 19 19 19 19 19 19 26 27 13 14 24 25 13 14 
34 35 19 19 19 19 19 19 36 37 13 14 34 35 13 14 
19 19 19 19 26 27 22 23 19 19 13 14 22 23 13 14 
19 19 19 19 36 37 1 1 19 19 13 14 32 33 1 1 
19 19 19 19 19 19 5 2 22 23 6 8 3 4 5 2 
19 19 19 19 19 19 13 14 32 33 13 14 15 15 13 14 
32 33 26 27 22 23 13 14 24 25 13 14 32 33 13 14 
1 1 36 37 1 1 1 1 9 10 1 1 1 1 1 1 
3 4 15 15 3 4 5 2 15 15 5 2 3 4 5 2 
15 15 15 15 15 15 13 14 15 15 13 14 15 15 13 14 

176
19 19 13 14 19 19 13 14 19 19 13 14 36 37 1 1 
19 19 13 14 19 19 13 14 26 27 13 14 22 23 1 1 
19 19 13 14 19 19 1 15 36 37 13 14 32 33 1 1 
22 23 13 14 26 27 13 14 22 23 13 14 32 33 1 1 
1 1 1 1 36 37 13 14 1 1 1 1 1 1 1 1 
3 4 13 14 32 33 6 8 3 4 5 2 3 4 1 1 
15 15 13 14 1 1 13 14 15 15 13 14 15 15 1 1 
22 23 13 14 22 23 13 14 22 23 13 14 22 23 1 1 
1 1 1 1 1 1 1 1 1 1 1 1 1 1 1 1 
3 4 5 2 3 4 5 2 3 4 5 2 3 4 1 1 
15 15 13 14 15 15 13 14 15 15 13 14 15 15 1 1 